17,225,18,42,40,34,663,18,56,20,8,53,
18,226,19,43,41,35,664,19,57,21,9,54,
19,227,20,44,51,37,665,20,58,55,10,55,
20,228,21,45,53,38,666,21,59,56,11,56,
21,229,22,46,54,39,667,22,60,57,12,57,
22,230,23,47,55,40,668,23,61,58,13,58,
280,46,48,56,41,715,40,62,59,14,59,
