492,29,9,193,47,9,9,37,9,37,49,93,32,44,44,23,35,7,35,7,7,7,7,
493,30,10,194,48,10,10,38,10,38,50,94,33,45,45,24,36,8,36,8,8,8,8,
494,31,11,195,49,11,11,39,11,39,51,95,34,46,46,25,37,9,37,9,9,9,9,
495,32,12,196,50,12,12,40,60,40,52,96,35,47,47,26,38,10,38,10,10,10,10,
496,33,13,197,51,13,13,41,61,41,53,97,36,48,48,27,39,11,39,11,11,11,11,
497,34,198,52,60,118,69,62,67,79,98,37,49,49,28,40,12,40,12,12,12,12,
94,445,17520,42258,19791,465,393,383,469,21536,402,469,485,449,
