19,202,14,10,10,10,10,218,10,23,49,41,837,41,41,14,14,11,12,13,14,21,24,19,41,41,14,41,10,19,45,37,14,13,27,14,26,14,29,26,31,14,28,31,14,11,4,16,18,19,
20,203,15,11,11,11,11,219,11,24,50,42,838,42,42,15,15,12,13,14,15,22,25,20,42,42,15,42,11,20,46,38,15,14,28,15,27,15,30,27,32,15,29,32,15,12,5,17,19,20,
21,204,16,12,12,12,12,220,12,25,51,43,839,43,43,16,16,13,14,15,16,23,26,21,43,43,16,43,20,21,47,39,16,15,29,16,28,16,31,28,33,16,30,33,16,13,6,18,20,21,
22,205,17,13,13,13,13,221,13,26,52,44,840,44,44,17,17,14,15,16,17,27,22,64,17,64,21,22,68,40,17,36,30,17,29,17,32,29,34,17,31,34,17,14,7,19,21,22,
23,206,18,14,14,14,14,222,14,27,53,45,841,45,45,18,18,15,16,17,18,28,23,65,18,65,22,23,69,41,18,37,31,18,30,18,33,30,35,18,32,35,18,15,8,22,23,
24,207,19,15,15,15,15,223,15,28,54,46,842,46,46,19,19,16,17,18,19,29,24,66,19,66,45,24,70,42,19,38,19,31,19,34,31,36,19,33,36,19,16,9,23,24,
448,283,226,473,333,499,424,219,1867744,72141,7785,13655,101384,8594,23624,36149,13616,37836,6089,23649,141540,
