3,65,13,43,63,15,8,3,66,50,65,3,6,72,47,27,13,3,20,3,4,72,52,7,3,3,43,48,66,13,13,6,3,80,80,80,37,10,6,3,16,16,12,56,3,3,4,15,48,44,15,56,3,29,28,16,3,83,12,16,13,60,34,52,14,3,23,36,12,16,13,37,36,19,64,48,64,14,34,3,14,36,12,16,13,66,14,3,74,12,14,74,44,70,76,52,
4,66,14,44,64,16,9,4,67,51,66,4,7,73,48,28,14,4,21,4,5,73,53,8,4,4,44,49,67,14,14,7,4,81,81,81,38,11,7,4,17,19,13,57,4,4,5,16,49,45,16,57,4,30,29,17,4,84,14,17,14,61,35,53,15,4,24,37,14,17,14,38,37,20,65,49,65,15,35,4,15,37,14,17,14,67,15,4,75,14,15,75,45,71,77,53,
5,67,15,47,65,17,10,5,68,52,67,5,8,74,49,59,15,7,22,5,6,74,54,9,7,5,45,50,68,15,15,8,5,82,82,82,39,12,8,5,18,20,14,58,5,5,6,17,50,46,19,58,5,31,48,18,5,85,16,18,15,62,36,54,16,5,25,38,16,18,17,39,38,21,66,50,67,16,36,5,16,38,16,18,15,68,16,5,76,16,16,76,46,72,78,64,
6,68,16,48,66,18,11,6,69,53,68,6,9,75,50,60,16,8,23,6,7,75,71,10,8,6,49,51,69,16,9,6,83,83,83,40,13,6,21,21,15,59,6,6,7,18,51,47,20,59,6,32,49,19,6,86,19,19,18,63,37,71,18,6,26,39,19,19,18,40,39,22,77,51,68,18,37,6,17,39,19,19,18,69,18,6,77,19,18,77,47,73,79,65,
19,69,17,49,67,19,18,7,70,54,69,7,10,76,51,61,17,12,24,7,8,78,72,11,12,7,50,52,70,17,7,84,84,84,41,14,7,22,22,16,60,7,7,8,19,52,48,23,60,7,33,50,20,7,87,21,20,19,64,38,72,19,7,27,40,21,20,19,41,40,23,78,52,69,19,38,7,18,40,21,20,19,70,19,7,78,21,19,78,48,74,80,66,
20,70,18,50,68,20,19,8,81,55,70,8,11,79,52,62,18,15,25,8,9,79,73,12,15,8,55,53,71,18,8,85,85,85,42,15,8,23,23,17,61,8,8,9,20,53,49,24,61,8,34,51,21,8,88,23,21,20,65,39,73,23,8,28,41,23,21,20,42,41,24,79,53,70,23,39,8,19,41,23,21,20,71,23,8,79,23,23,81,49,75,81,67,
64,71,63,51,69,21,67,71,82,56,71,61,80,53,72,45,72,76,78,80,80,56,39,58,54,72,69,24,86,86,86,48,47,23,24,24,21,62,25,30,21,54,50,52,62,24,35,52,22,51,91,50,22,21,66,43,74,76,65,29,42,43,22,21,43,42,25,80,54,71,76,40,51,20,42,30,22,21,72,76,24,80,56,52,82,50,76,82,68,
