753,3,67,3,3,67,66,65,60,66,65,67,66,65,54,65,66,55,65,67,58,67,65,65,65,65,66,65,65,67,65,67,65,65,66,65,65,67,65,67,65,65,65,65,67,65,49,65,67,65,65,65,65,65,65,65,65,65,65,65,65,65,65,65,65,65,64,53,65,55,65,65,49,65,65,65,65,65,65,65,65,65,65,53,65,53,58,58,65,65,65,65,58,51,65,65,65,55,49,64,65,65,65,55,59,65,66,57,54,61,41,65,65,65,65,65,65,49,53,58,49,59,60,53,53,67,67,65,65,65,66,66,54,60,52,59,65,56,53,65,65,55,51,48,55,60,66,54,53,49,65,66,65,65,58,65,65,56,60,66,49,48,49,65,59,51,65,65,66,65,49,65,63,53,67,65,67,67,65,67,65,65,65,65,65,65,58,65,49,65,53,49,65,65,65,60,65,65,65,49,60,65,65,63,66,63,65,55,39,65,53,65,65,65,53,64,51,57,49,53,65,65,65,51,65,65,58,65,65,65,67,67,61,58,66,55,63,63,57,65,49,67,61,65,66,49,49,65,48,67,59,57,53,51,66,59,65,57,67,58,67,65,65,65,67,65,67,65,53,65,49,65,55,65,49,53,63,65,58,49,65,65,51,65,65,65,55,65,65,65,65,65,60,65,49,65,65,65,65,65,65,63,65,59,65,49,57,51,60,65,65,65,63,65,65,49,65,51,65,65,53,65,62,65,67,65,67,65,65,65,66,65,63,65,67,55,67,65,67,51,45,51,67,58,55,58,59,55,67,67,67,67,67,66,49,65,42,59,67,65,55,62,55,67,65,47,49,52,59,49,65,49,64,45,51,65,65,49,65,55,65,67,51,58,65,65,65,59,49,67,65,65,65,65,58,60,67,60,45,49,58,65,65,67,
754,4,68,4,4,68,67,66,61,67,66,68,67,66,55,66,67,56,66,68,59,68,66,66,66,66,67,66,66,68,66,68,66,66,67,66,66,68,66,68,66,66,66,66,68,66,50,66,68,66,66,66,66,66,66,66,66,66,66,66,66,66,66,66,66,66,66,54,66,56,66,66,50,66,66,66,66,66,66,66,66,66,66,54,66,54,59,59,66,66,66,66,59,52,66,66,66,56,50,65,66,66,66,56,60,66,67,62,55,62,42,66,66,66,66,66,66,50,54,59,50,60,61,54,54,68,68,66,66,66,67,67,55,61,53,60,66,57,54,66,66,56,52,49,56,61,67,55,54,50,66,67,66,66,59,66,66,57,61,67,50,49,50,66,60,52,66,66,67,66,50,66,66,54,68,66,68,68,66,68,66,66,66,66,66,66,59,66,50,66,54,50,66,66,66,61,66,66,66,50,61,66,66,64,67,64,66,56,40,66,54,66,66,66,54,65,52,58,50,54,66,66,66,54,66,66,59,66,66,66,68,68,62,59,67,56,64,64,58,66,50,68,62,66,67,50,50,66,49,68,60,60,54,52,67,60,66,58,68,59,68,66,66,66,68,66,68,66,54,66,50,66,56,66,50,54,64,66,59,50,66,66,52,66,66,66,56,66,66,66,66,66,61,66,50,66,66,66,66,66,66,64,66,60,66,50,58,52,61,66,66,66,64,66,66,50,66,52,66,66,54,66,63,66,68,66,68,66,66,66,67,66,68,66,68,56,68,66,68,52,46,52,68,59,56,59,60,56,68,68,68,68,68,67,50,66,43,60,68,66,56,63,56,68,66,48,50,53,62,50,66,50,65,46,52,66,66,50,66,56,66,68,52,59,66,66,66,68,50,68,66,66,66,66,59,61,68,61,46,50,59,66,66,68,
755,5,69,5,5,69,68,67,62,68,67,69,68,67,56,67,68,57,67,69,60,69,67,67,67,67,68,67,67,69,67,69,67,67,68,67,67,69,67,69,67,67,67,67,69,67,51,67,69,67,67,67,67,67,67,67,67,67,67,67,67,67,67,67,67,67,67,55,67,57,67,67,51,67,67,67,67,67,67,67,67,67,67,55,67,55,60,60,67,67,67,67,61,53,67,67,67,57,51,67,67,67,67,57,61,67,68,63,56,63,43,67,67,67,67,67,67,51,55,60,51,61,62,55,55,69,69,67,67,67,68,68,56,62,54,61,67,58,55,67,67,57,53,50,57,62,68,56,55,51,67,68,67,67,60,67,67,58,62,68,51,50,51,67,61,53,67,67,68,67,51,67,67,55,69,67,69,69,67,69,67,67,67,67,67,67,60,67,51,67,55,51,67,67,67,62,67,67,67,51,62,67,67,65,68,65,67,57,41,67,55,67,67,67,55,67,53,59,51,55,67,67,67,55,67,67,60,67,67,67,69,69,63,61,68,57,65,65,59,67,51,69,63,67,68,51,51,67,50,69,61,61,55,53,68,61,67,59,69,60,69,67,67,67,69,67,69,67,55,67,51,67,57,67,51,55,65,67,60,51,67,67,53,67,67,67,57,67,67,67,67,67,62,67,51,67,67,67,67,67,67,65,67,61,67,51,60,53,62,67,67,67,65,67,67,51,67,53,67,67,55,67,64,67,69,67,69,67,67,67,68,67,69,67,69,57,69,67,69,53,47,53,69,60,57,60,61,57,69,69,69,69,69,68,51,67,44,61,69,67,57,64,57,69,67,49,51,54,63,51,67,51,66,47,53,67,67,51,67,57,67,69,53,60,67,67,67,69,51,69,67,67,67,67,60,62,69,62,47,51,60,67,67,69,
756,6,70,6,6,70,69,68,63,69,68,70,69,68,57,68,69,58,68,70,61,70,68,68,68,68,69,68,68,70,68,70,68,68,69,68,68,70,68,70,68,68,68,68,70,68,52,68,70,68,68,68,68,68,68,68,68,68,68,68,68,68,68,68,68,68,68,56,68,58,68,68,52,68,68,68,68,68,68,68,68,68,68,56,68,56,61,61,68,68,68,68,62,54,68,68,68,58,52,68,68,68,68,58,62,68,69,64,57,64,44,68,68,68,68,68,68,52,56,61,52,62,63,56,56,70,70,68,68,68,69,69,57,63,55,62,68,59,56,68,68,58,54,51,58,63,69,57,56,52,68,69,68,68,61,68,68,60,63,69,52,51,52,68,62,54,68,68,69,68,52,68,68,56,70,68,70,70,68,70,68,68,68,68,68,68,61,68,52,68,56,52,68,68,68,63,68,68,68,52,63,68,68,66,69,66,68,58,42,68,56,68,68,68,56,68,54,60,52,56,68,68,68,56,68,68,61,68,68,68,70,70,64,63,69,58,66,66,60,68,52,70,66,68,69,52,52,68,51,70,62,62,56,54,69,62,68,60,70,61,70,68,68,68,70,68,70,68,56,68,52,68,58,68,52,56,66,68,61,52,68,68,54,68,68,68,58,68,68,68,68,68,63,68,52,68,68,68,68,68,68,66,68,62,68,52,61,54,63,68,68,68,66,68,68,52,68,54,68,68,56,68,65,68,70,68,70,68,68,68,69,68,70,68,70,58,70,68,70,54,48,54,70,61,58,61,62,58,70,70,70,70,70,69,52,68,45,62,70,68,58,65,58,70,68,50,52,55,64,52,68,52,67,48,54,68,68,52,68,58,68,70,54,61,68,68,68,70,52,70,68,68,68,68,61,64,70,63,50,52,61,68,68,70,
757,7,71,7,7,71,70,69,64,70,69,71,70,69,58,69,70,59,69,71,62,71,69,69,69,69,70,69,69,71,69,71,69,69,70,69,69,71,69,71,69,69,69,69,71,69,53,69,71,69,69,69,69,69,69,69,69,69,69,69,69,69,69,69,69,69,69,57,69,61,69,69,53,69,69,69,69,69,69,69,69,69,69,57,69,57,62,62,69,69,69,69,63,55,69,69,69,59,53,69,69,69,69,59,63,69,70,65,58,65,45,69,69,69,69,69,69,53,57,63,53,63,64,57,57,71,71,69,69,69,70,70,58,64,56,63,69,60,57,69,69,59,55,52,59,64,70,59,57,53,69,70,69,69,62,69,69,61,64,70,53,52,53,69,63,55,69,69,70,69,53,69,69,57,71,69,71,71,69,71,69,69,69,69,69,69,62,69,53,69,57,53,69,69,69,64,69,69,69,53,64,69,69,67,70,67,69,61,43,69,59,69,69,69,57,69,55,61,55,57,69,69,69,57,69,69,62,69,69,69,71,71,65,64,70,59,67,67,61,69,53,71,67,69,70,53,53,69,52,71,63,63,57,55,70,65,69,61,71,62,71,69,69,69,71,69,71,69,57,69,53,69,59,69,53,57,68,69,62,53,69,69,55,69,69,69,59,69,69,69,69,69,64,69,53,69,69,69,69,69,69,67,69,64,69,53,62,57,64,69,69,69,67,69,69,53,69,55,69,69,57,69,66,69,71,69,71,69,69,69,70,69,71,69,71,61,71,69,71,55,49,55,71,62,59,62,63,59,71,71,71,71,71,70,53,69,46,63,71,69,59,66,59,71,69,51,53,56,65,53,69,53,68,49,55,69,69,53,69,59,69,71,55,62,69,69,69,71,53,71,69,69,69,69,62,65,71,64,51,53,62,69,69,71,
758,8,72,8,8,72,71,70,66,71,70,72,71,71,59,71,71,60,70,74,63,72,70,70,70,71,71,70,70,74,70,72,70,71,71,70,70,74,70,72,70,71,70,70,72,70,54,70,74,70,70,70,70,70,70,70,70,70,70,70,70,70,70,70,70,70,70,58,70,62,70,70,54,70,70,70,70,70,70,70,70,70,70,58,70,58,63,63,70,70,70,70,64,56,70,70,70,60,54,70,70,70,70,60,66,70,71,66,59,67,46,70,70,70,70,70,70,54,58,64,54,64,65,58,58,72,72,71,70,70,71,71,60,65,57,64,70,61,59,70,70,60,56,53,60,65,71,60,58,54,70,71,70,70,63,70,70,62,65,71,54,53,54,70,64,56,70,70,71,70,54,70,70,58,74,70,72,74,70,74,70,70,70,70,70,70,63,70,54,70,58,54,70,70,70,65,70,70,70,54,65,70,70,68,71,68,70,62,44,70,60,70,70,70,58,70,56,62,56,58,70,70,70,58,70,70,63,70,70,70,72,72,66,65,71,60,68,68,62,70,54,72,68,70,71,54,54,70,53,72,64,65,58,56,71,66,70,64,74,63,72,70,70,70,72,70,72,70,58,70,54,70,60,70,54,58,69,70,63,54,70,70,56,70,70,70,60,70,70,70,70,70,65,70,54,70,70,70,70,70,70,68,70,65,70,54,63,58,65,70,70,70,68,70,70,54,70,56,70,70,58,70,67,70,72,70,74,70,70,70,71,70,72,70,72,62,74,70,72,56,50,56,72,63,60,63,64,60,72,72,72,72,72,71,54,70,47,64,74,70,60,67,60,72,71,52,54,57,66,54,70,54,69,52,56,70,70,54,70,60,70,72,56,63,70,70,70,72,54,72,70,70,70,70,63,66,72,65,52,54,63,70,70,74,
785,69,73,71,67,73,72,71,67,72,71,73,72,72,60,72,72,61,71,75,64,73,72,71,72,72,72,71,72,75,71,73,72,72,72,71,72,75,71,73,72,72,72,71,73,72,55,72,75,72,72,72,72,72,72,72,72,72,72,72,72,72,72,71,71,71,71,59,71,63,72,71,55,71,71,71,72,72,71,71,71,71,71,59,71,59,65,64,72,72,72,71,65,57,72,72,71,63,55,71,71,72,71,62,68,71,72,67,60,68,47,71,72,71,72,71,71,55,59,65,55,65,66,59,59,73,73,72,71,72,72,72,61,66,58,65,71,62,60,71,71,61,57,54,61,66,72,61,59,55,71,72,71,71,64,71,71,63,66,72,55,54,55,71,65,57,71,71,72,71,55,71,71,59,75,72,73,75,71,75,71,72,71,71,72,71,64,71,55,71,59,55,71,71,71,66,71,71,71,55,66,71,71,69,72,69,71,63,45,71,61,72,72,71,59,71,57,64,57,59,72,71,71,59,71,71,64,71,71,72,73,73,67,66,72,61,69,69,63,71,55,73,69,71,72,55,55,71,54,73,65,66,59,57,72,67,71,65,75,64,73,71,71,72,73,71,73,72,59,71,55,71,61,71,55,59,70,71,64,55,71,71,57,71,71,71,61,71,71,71,72,71,66,72,55,71,71,72,71,72,72,69,72,66,71,55,64,59,66,72,72,71,69,71,72,55,71,57,72,72,59,72,68,71,73,71,75,71,71,72,72,71,73,71,73,63,75,71,73,57,51,57,73,64,61,67,65,61,73,73,73,73,73,72,55,72,48,65,75,71,61,68,61,73,72,53,55,58,67,55,71,55,70,53,57,71,71,55,71,61,72,73,57,64,71,71,71,73,55,73,71,71,71,71,64,67,73,66,53,55,65,71,71,75,
