3,4,5,136,402,5,21,77,3,314,18,8,9,6,3,3,50,33,63,49,50,50,45,57,41,52,49,45,41,61,49,45,32,16,49,45,33,63,49,45,40,64,49,45,40,63,33,63,41,40,41,32,35,49,45,49,41,33,62,45,40,60,45,40,70,45,49,33,76,33,59,50,41,33,11,45,32,13,33,16,32,17,33,60,45,49,45,33,13,32,14,66,45,49,50,41,40,70,45,49,45,32,54,49,45,49,50,49,45,41,70,41,49,45,33,30,41,49,45,33,70,45,49,45,33,11,45,49,45,40,70,45,49,45,33,70,41,32,13,45,33,57,41,33,11,41,32,13,45,33,12,70,50,41,32,11,32,13,32,13,33,16,33,63,32,17,41,32,12,35,50,49,45,33,70,41,71,45,49,49,50,41,33,13,41,49,33,70,45,32,70,45,49,49,50,33,55,45,32,70,32,52,32,13,33,16,33,70,32,13,33,70,40,63,40,72,41,32,35,50,41,49,32,13,33,70,50,45,49,50,33,13,45,41,49,33,70,45,49,45,49,49,41,42,19,41,49,50,43,55,50,45,49,41,33,70,45,49,41,41,40,56,45,49,43,70,45,50,50,49,41,32,70,41,49,41,49,50,45,40,70,49,45,49,41,65,50,45,41,33,70,41,49,41,60,40,61,40,46,45,32,13,50,41,40,70,32,64,32,72,41,32,59,49,33,13,
4,5,6,137,403,6,22,78,4,315,9,10,7,4,4,52,34,64,50,51,51,46,58,43,53,50,46,42,62,50,46,33,17,50,46,34,64,50,46,41,65,50,46,41,64,34,64,42,41,42,33,36,50,46,50,42,34,63,46,41,61,46,41,71,46,50,34,77,34,60,51,42,34,12,46,33,14,34,17,33,18,34,61,46,50,46,34,14,33,15,67,46,50,51,42,41,71,46,50,46,33,55,50,46,50,51,50,46,43,71,42,50,46,34,31,42,50,46,34,71,46,50,46,34,12,46,50,46,41,71,46,50,46,34,71,42,33,14,46,34,58,42,34,12,42,33,14,46,34,13,71,51,42,33,12,33,14,33,14,34,71,34,64,33,18,42,33,13,36,51,50,46,34,71,43,72,46,50,50,51,42,34,71,42,50,34,71,46,33,71,46,50,50,51,34,56,46,33,71,33,53,33,14,34,71,34,71,33,14,34,71,41,64,41,73,42,33,36,51,42,50,33,14,34,71,51,46,50,51,34,14,46,42,50,34,71,46,50,46,50,50,42,44,20,42,50,51,44,56,51,46,50,42,34,71,46,50,42,42,41,57,46,50,44,71,46,51,51,50,42,33,71,42,50,42,50,51,46,41,71,50,46,50,43,66,51,46,42,34,71,42,50,43,61,41,62,41,47,46,33,14,51,42,41,71,33,65,33,73,42,33,60,50,34,63,
5,6,7,138,9,23,79,5,316,10,11,8,5,5,53,35,65,51,52,52,47,59,44,54,51,47,43,63,51,47,34,18,51,47,35,65,51,47,43,66,51,47,43,65,35,65,43,43,43,34,37,51,47,51,43,35,64,47,43,62,47,44,72,47,51,35,78,35,61,52,43,35,13,47,34,28,35,18,35,19,35,62,47,51,47,35,72,34,16,68,47,51,52,43,44,72,47,51,47,35,56,52,47,51,52,51,47,44,72,43,51,47,35,32,43,51,47,35,72,47,51,47,35,13,47,51,47,44,72,47,51,47,35,72,43,34,72,47,35,59,43,35,13,43,34,15,47,35,72,52,43,34,13,34,15,34,15,35,72,35,65,34,19,43,34,14,37,52,51,47,35,72,44,73,47,51,51,52,43,35,72,43,51,35,72,47,34,72,47,51,51,52,35,57,47,34,72,34,54,35,15,35,72,35,72,35,15,35,72,43,65,43,74,43,34,37,52,43,51,34,15,35,72,52,47,51,52,35,72,47,43,51,35,72,47,51,47,52,51,43,45,21,43,51,52,45,57,52,47,51,43,35,72,47,51,43,43,44,58,47,51,45,72,47,52,52,51,43,34,72,43,51,43,51,52,47,44,72,51,47,51,44,67,52,47,43,35,72,43,51,44,62,44,63,43,48,47,34,15,52,43,42,72,35,66,34,74,43,34,61,51,35,64,
6,7,8,139,24,80,6,317,11,12,9,6,6,54,36,66,52,53,53,48,60,45,55,52,48,44,64,52,48,36,70,52,48,36,66,52,48,44,67,52,48,44,66,36,66,44,44,44,36,38,52,48,52,44,36,65,48,44,63,48,45,73,48,52,36,79,36,62,53,44,36,63,48,36,29,36,19,36,20,36,63,48,52,48,36,73,36,69,48,52,53,44,45,73,48,52,48,36,57,53,48,52,53,52,48,45,73,44,52,48,36,33,44,52,48,36,73,48,52,48,36,14,48,52,48,45,73,48,52,48,36,73,44,36,73,48,36,60,44,36,14,44,36,16,48,36,73,53,44,36,14,36,16,36,16,36,73,36,66,36,20,44,36,38,53,52,48,36,73,45,74,48,52,52,53,44,36,73,44,52,36,73,48,36,73,48,52,52,53,36,58,48,36,73,36,55,36,38,36,73,36,73,36,16,36,73,44,66,44,75,44,36,38,53,44,52,36,16,36,73,53,48,52,53,36,73,48,44,52,36,73,48,52,48,53,52,44,46,22,44,52,53,46,58,53,48,52,44,36,73,48,52,44,44,45,59,48,52,49,73,48,53,53,52,44,36,73,44,52,44,52,53,48,45,73,52,48,52,45,68,53,48,44,36,73,44,52,45,63,45,64,44,49,48,36,16,53,44,43,73,36,67,36,75,44,36,62,52,36,65,
7,8,9,25,81,7,318,12,24,10,7,7,55,37,67,53,54,54,49,61,46,56,53,49,45,65,53,49,37,71,53,49,37,67,53,49,45,68,53,49,45,67,37,67,47,45,47,37,39,53,49,53,47,37,66,49,45,64,49,46,74,49,53,37,80,37,63,54,47,37,64,49,37,42,37,20,37,21,37,64,49,53,49,37,74,37,70,49,53,54,47,46,74,49,54,49,37,58,54,49,53,54,53,49,46,74,47,53,49,43,34,47,53,49,37,74,49,53,49,37,74,49,53,49,46,74,49,53,49,37,74,47,37,74,49,37,61,45,37,74,45,37,17,49,37,74,54,45,37,74,37,17,37,19,37,74,37,67,37,21,47,37,39,54,53,49,37,74,46,75,49,53,53,54,47,37,74,47,53,37,74,49,37,74,49,53,53,54,37,59,49,37,74,37,56,37,74,37,74,37,74,37,69,37,74,45,67,45,76,45,37,39,54,45,53,37,74,37,74,54,49,53,54,37,74,49,45,53,37,74,49,53,49,54,53,47,47,23,47,53,54,48,59,54,49,53,45,37,74,49,53,45,47,46,60,49,53,50,74,49,54,54,53,45,37,74,45,53,47,53,54,49,46,74,53,49,53,46,69,54,49,45,37,74,47,53,46,64,46,65,45,50,49,37,17,54,45,44,74,37,68,37,76,47,37,63,53,37,66,
8,9,10,26,82,8,319,13,25,11,8,8,56,46,68,54,55,55,50,62,48,57,54,50,46,66,54,50,38,72,54,50,42,68,54,50,46,69,54,50,46,68,42,68,48,46,48,38,40,54,50,54,48,38,67,50,46,65,50,47,75,50,54,38,81,44,64,55,48,45,65,50,38,43,45,21,38,22,42,65,50,54,50,44,75,38,71,50,54,55,48,47,75,50,55,50,38,59,55,50,54,55,54,50,48,75,48,54,50,46,35,48,54,50,38,75,50,54,50,45,75,50,54,50,47,75,50,54,50,38,75,48,38,75,50,43,62,48,45,75,48,38,18,50,38,75,55,48,38,75,38,75,38,20,38,75,42,68,38,22,48,38,40,55,54,50,38,75,48,76,50,54,54,55,48,45,75,48,54,38,75,50,38,75,50,54,54,55,46,60,50,38,75,38,57,38,75,45,75,42,75,38,70,38,75,46,68,46,77,48,38,40,55,46,54,38,75,38,75,55,50,54,55,38,75,50,46,54,38,75,50,54,50,55,54,48,48,24,48,54,55,49,60,55,50,55,48,38,75,50,54,48,48,47,61,50,54,51,75,50,55,55,54,48,38,75,48,54,48,54,55,50,47,75,54,50,54,48,70,55,50,48,38,75,48,54,47,65,47,66,46,51,50,38,18,55,48,45,75,38,69,38,77,48,38,64,54,43,67,
53,83,83,363,64,60,57,51,57,47,69,55,56,56,51,63,49,58,55,51,48,67,55,51,40,73,55,51,45,69,55,51,47,70,55,51,48,69,43,69,49,47,49,39,41,55,51,55,49,39,68,51,48,66,51,48,76,51,55,45,82,46,65,56,49,46,66,51,42,76,46,63,44,23,43,66,51,55,51,45,76,42,74,51,55,56,49,48,76,51,56,51,47,60,56,51,55,56,55,51,49,76,49,55,51,47,36,49,55,51,46,76,51,55,51,46,76,51,55,51,48,76,51,55,51,46,76,49,40,76,51,46,63,49,46,76,49,39,19,51,46,76,56,49,39,76,39,76,42,21,46,76,45,69,42,23,49,39,41,56,55,51,45,76,49,77,51,55,55,56,49,46,76,49,55,47,76,51,39,76,51,55,55,56,47,61,51,39,76,40,58,39,76,46,76,45,76,46,71,39,76,48,69,48,78,49,42,41,56,47,55,39,76,39,76,56,51,55,56,39,76,51,47,55,39,76,51,55,51,56,55,49,49,25,49,55,56,50,61,56,51,56,49,39,76,51,56,49,49,48,62,51,56,52,76,51,56,56,56,49,40,76,49,55,49,55,56,51,48,76,55,51,55,49,71,56,51,49,39,76,49,55,48,66,48,67,48,52,51,39,19,56,49,46,76,39,70,39,78,49,40,65,55,44,68,
