16,18,298,10,4,14,18,26,18966522,6,6,14,61,293,293,
17,19,299,11,5,15,19,7,15,62,294,294,
18,20,300,12,43,16,20,8,16,108,340,340,
38,21,301,13,44,17,21,9,17,109,341,341,
39,22,302,14,42,22,10,58,110,342,342,
47,23,303,15,43,23,11,59,214,446,446,
345,
