32,185,106,106,106,106,477,13,8,60,60,60,
33,186,107,107,107,107,478,14,9,61,61,61,
34,187,108,108,108,108,479,15,10,62,62,62,
35,188,109,109,109,109,480,16,11,63,63,63,
36,189,110,110,110,110,481,17,12,64,64,64,
37,190,111,111,111,111,482,18,13,65,65,65,
184,447,329836,949,42772,275,275,275,
