492,29,9,234,47,9,9,37,9,37,49,93,32,17,44,23,35,7,35,7,7,7,7,
493,30,10,235,48,10,10,38,10,38,50,94,33,18,45,24,36,8,36,8,8,8,8,
494,31,11,236,49,11,11,39,11,39,51,95,34,19,46,25,37,9,37,9,9,9,9,
495,32,12,237,50,12,12,40,60,40,52,96,35,20,47,26,38,10,38,10,10,10,10,
496,33,13,238,51,13,13,41,61,41,53,97,36,21,48,27,39,11,39,11,11,11,11,
497,34,239,52,60,127,69,62,67,79,98,37,22,49,28,40,12,40,12,12,12,12,
744,86,364,17211,42375,20162,387,385,375,3426,45932,394,4636,394,28805,
