3,38,8,11,40,43,8,3,34,45,34,3,57,4,19,12,3,3,4,36,44,7,3,3,50,35,26,13,6,3,62,72,46,10,6,3,8,8,10,18,3,3,3,45,40,32,3,3,3,10,6,68,3,75,12,6,5,38,26,44,14,3,36,18,12,6,5,6,20,13,26,40,47,14,26,3,6,30,12,11,5,18,14,3,44,12,14,18,36,38,68,31,
4,39,9,12,41,47,9,4,35,46,35,4,58,5,20,13,4,4,5,37,61,8,4,4,51,40,27,14,7,4,63,73,49,11,7,4,9,9,11,19,4,4,4,47,41,33,4,4,4,11,7,69,4,76,14,7,6,39,27,45,15,4,37,19,14,7,6,7,21,14,45,41,57,15,27,4,7,31,14,23,6,19,15,4,46,14,15,19,37,39,69,45,
5,40,10,13,42,48,10,5,56,47,36,5,66,6,21,14,7,5,6,38,68,9,7,5,52,41,28,15,8,5,64,74,50,12,8,5,10,10,12,20,5,5,5,48,42,34,5,5,5,12,8,70,5,77,16,8,7,41,28,46,16,5,38,20,16,8,7,8,26,33,46,42,58,16,28,5,8,32,16,24,7,20,16,5,47,16,16,20,38,40,70,46,
6,41,13,14,43,49,11,6,57,48,37,6,67,7,22,15,8,6,7,39,69,10,8,6,53,42,29,16,9,6,65,75,51,13,6,11,11,13,21,6,6,6,49,43,35,6,6,6,13,9,71,6,78,19,11,8,42,29,63,18,6,39,21,19,9,8,9,27,34,47,43,59,18,29,6,9,33,19,25,8,21,18,6,48,19,18,21,39,41,71,47,
19,42,17,15,45,50,18,7,58,49,38,7,68,8,53,16,12,7,8,40,70,11,12,7,54,43,30,17,7,66,76,52,14,7,12,12,14,22,7,7,7,50,44,36,7,7,7,14,10,72,7,79,21,12,9,43,30,64,19,7,40,22,21,12,9,10,28,35,48,44,60,19,30,7,10,34,21,26,9,22,19,7,49,21,19,22,40,42,72,48,
20,49,18,16,46,51,19,8,59,50,39,8,69,9,54,17,15,8,9,41,71,12,15,8,55,44,31,18,8,67,77,53,15,8,13,13,15,23,8,8,8,51,45,37,8,8,8,15,11,73,8,80,22,13,10,44,31,65,23,8,41,23,23,13,10,11,29,36,61,45,61,23,31,8,11,35,23,27,10,23,23,8,50,23,23,23,41,43,73,49,
56,50,55,17,47,52,59,63,60,51,62,53,70,45,55,39,64,68,65,70,72,48,15,56,45,32,61,67,68,78,54,16,11,14,14,16,24,42,25,52,46,38,44,54,16,16,12,74,68,81,23,14,11,58,32,66,44,44,42,24,24,14,11,12,32,37,62,46,62,44,32,37,12,36,48,28,11,24,44,16,51,48,44,24,42,44,74,50,
