14,153,26,5,8,5,364,5,8,64,14,31,55,7,34,12,10,55,39,39,7,34,12,10,42,7,32,10,42,7,32,10,55,7,12,10,42,7,32,8,10,55,7,12,10,32,10,7,32,7,12,8,25,10,42,7,42,7,32,10,7,32,14,8,10,7,32,10,7,42,32,14,32,10,39,7,32,10,7,32,10,32,10,32,10,32,28,26,7,42,7,32,10,32,14,28,7,42,39,7,32,10,7,42,7,32,8,10,39,7,42,39,39,7,32,10,7,42,7,32,10,7,42,7,32,10,7,42,7,32,10,7,42,7,32,14,10,7,42,7,32,10,7,32,10,7,32,14,10,7,32,10,7,32,10,7,32,8,10,39,7,32,10,32,10,32,10,32,10,32,10,32,10,7,12,28,10,39,42,7,32,10,32,26,7,42,42,39,7,32,10,7,42,32,14,10,7,32,10,7,42,42,39,32,10,7,32,10,32,10,32,10,32,10,32,10,32,10,32,10,32,10,32,10,7,12,10,39,7,42,32,10,32,10,39,7,42,39,32,10,7,7,42,32,10,7,42,7,42,42,7,29,10,7,42,39,32,10,42,7,42,7,32,10,7,42,7,7,32,10,7,42,32,10,7,42,39,39,7,32,10,7,42,7,42,39,7,32,10,42,7,42,32,10,39,7,7,32,10,7,42,32,10,32,10,32,10,7,32,10,39,7,32,10,32,10,32,10,7,32,10,42,32,10,
15,154,27,6,9,6,365,6,9,65,15,32,56,8,35,13,11,56,40,40,8,35,13,11,43,8,33,11,43,8,33,11,56,8,13,11,43,8,33,9,11,56,8,13,11,33,11,8,33,8,13,9,26,11,43,8,43,8,33,11,8,33,15,9,11,8,33,11,8,43,33,15,33,11,40,8,33,11,8,33,11,33,11,33,11,33,29,27,8,43,8,33,11,33,15,29,8,43,40,8,33,11,8,43,8,33,9,11,40,8,43,40,40,8,33,11,8,43,8,33,11,8,43,8,33,11,8,43,8,33,11,8,43,8,33,15,11,8,43,8,33,11,8,33,11,8,33,15,11,8,33,11,8,33,11,8,33,9,11,40,8,33,11,33,11,33,11,33,11,33,11,33,11,8,13,29,11,40,43,8,33,11,33,27,8,43,43,40,8,33,11,8,43,33,15,11,8,33,11,8,43,43,40,33,11,8,33,11,33,11,33,11,33,11,33,11,33,11,33,11,33,11,33,11,8,13,11,40,8,43,33,11,33,11,40,8,43,40,33,11,8,8,43,33,11,8,43,8,43,43,8,30,11,8,43,40,33,11,43,8,43,8,33,11,8,43,8,8,33,11,8,43,33,11,8,43,40,40,8,33,11,8,43,8,43,40,8,33,11,43,8,43,33,11,40,8,8,33,11,8,43,33,11,33,11,33,11,8,33,11,40,8,33,11,33,11,33,11,8,33,11,43,33,11,
16,155,28,7,10,7,366,7,10,66,16,33,57,9,36,14,12,57,41,41,9,36,14,12,55,9,34,12,55,9,34,12,57,9,14,12,55,9,34,10,12,57,9,14,12,34,12,9,34,9,14,10,12,55,9,44,9,34,12,9,34,16,10,12,9,34,12,9,44,34,16,34,12,41,9,34,12,9,34,12,34,12,34,12,34,30,28,9,44,9,34,12,34,16,30,9,44,41,9,34,12,9,44,9,34,10,12,41,9,44,41,41,9,34,12,9,44,9,34,12,9,44,9,34,12,9,44,9,34,12,9,44,9,34,16,12,9,44,9,34,12,9,34,12,9,34,16,12,9,34,12,9,34,12,9,34,10,12,41,9,34,12,34,12,34,12,34,12,34,12,34,12,9,14,30,12,41,44,9,34,12,34,28,9,44,44,41,9,34,12,9,44,34,16,12,9,34,12,9,44,44,41,34,12,9,34,12,34,12,34,12,34,12,34,12,34,12,34,12,34,12,34,12,9,14,12,41,9,44,34,12,34,12,41,9,44,41,34,12,9,9,44,34,12,9,44,9,44,44,9,31,12,9,44,41,34,12,44,9,44,9,34,12,9,44,9,9,34,12,9,44,34,12,9,44,41,41,9,34,12,9,44,9,44,41,9,34,12,44,9,44,34,12,41,9,9,34,12,9,44,34,12,34,12,34,12,9,34,12,41,9,34,12,34,12,34,12,9,34,12,44,34,12,
17,156,29,14,11,8,367,8,11,67,17,34,58,10,43,15,13,58,42,42,10,43,15,13,56,10,41,13,56,10,41,13,58,10,15,13,56,10,41,11,13,58,10,15,13,41,13,10,41,10,15,11,13,56,10,45,10,41,13,10,41,34,11,13,10,41,13,10,45,41,17,41,13,42,10,41,13,10,41,13,41,13,41,13,41,31,29,10,45,10,41,13,41,34,31,10,45,42,10,41,13,10,45,10,41,11,13,42,10,45,42,42,10,41,13,10,45,10,41,13,10,45,10,41,13,10,45,10,41,13,10,45,10,41,17,13,10,45,10,41,13,10,41,13,10,41,17,13,10,41,13,10,41,13,10,41,11,13,42,10,41,13,41,13,41,13,41,13,41,13,41,13,10,15,31,13,42,45,10,41,13,41,29,10,45,45,42,10,41,13,10,45,41,17,13,10,41,13,10,45,45,42,41,13,10,41,13,41,13,41,13,41,13,41,13,41,13,41,13,41,13,41,13,10,15,13,42,10,45,35,13,41,13,42,10,45,42,41,13,10,10,45,41,13,10,45,10,45,45,10,32,13,10,45,42,41,13,45,10,45,10,41,13,10,45,10,10,41,13,10,45,41,13,10,45,42,42,10,41,13,10,45,10,45,42,10,41,13,45,10,45,41,13,42,10,10,41,13,10,45,41,13,41,13,41,13,10,41,13,42,10,41,13,35,13,41,13,10,41,13,45,41,13,
18,157,15,12,9,368,9,12,68,18,35,59,11,44,16,14,59,43,43,11,44,16,14,57,11,42,14,57,11,42,14,59,11,16,14,57,11,42,12,14,59,11,16,14,42,14,11,42,11,16,12,14,57,11,46,11,42,14,11,42,35,12,14,11,42,14,11,46,42,18,42,14,43,11,42,14,11,42,14,42,14,42,14,42,32,30,11,46,11,42,14,42,35,32,11,46,43,11,42,14,11,46,11,42,12,14,43,11,46,43,43,11,42,14,11,46,11,42,14,11,46,11,42,14,11,46,11,42,14,11,46,11,42,18,14,11,46,11,42,14,11,42,14,11,42,18,14,11,42,14,11,42,14,11,42,12,14,43,11,42,14,42,14,42,14,42,14,42,14,42,14,11,16,32,14,43,46,11,42,14,42,30,11,46,46,43,11,42,14,11,46,42,18,14,11,42,14,11,46,46,43,42,14,11,42,14,42,14,42,14,42,14,42,14,42,14,42,14,42,14,42,14,11,16,14,43,11,46,36,14,42,14,43,11,46,43,42,14,11,11,46,42,14,11,46,11,46,46,11,33,14,11,46,43,42,14,46,11,46,11,42,14,11,46,11,11,42,14,11,46,42,14,11,46,43,43,11,42,14,11,46,11,46,43,11,42,14,46,11,46,42,14,43,11,11,42,14,11,46,42,14,42,14,42,14,11,42,14,43,11,42,14,36,14,42,14,11,42,14,46,42,14,
19,158,16,13,10,369,10,13,69,19,36,60,12,45,17,32,60,44,44,12,45,17,32,58,12,94,32,58,12,98,32,60,12,17,32,58,12,98,13,15,60,12,17,32,94,32,12,94,12,17,13,15,58,12,47,12,94,32,12,98,13,32,12,94,32,12,47,98,19,94,32,44,12,98,32,12,94,32,98,32,94,32,98,31,12,47,12,94,32,98,50,12,47,44,12,94,32,12,47,12,98,13,32,44,12,47,44,44,12,94,32,12,47,12,98,32,12,47,12,94,32,12,47,12,98,32,12,47,12,94,19,32,12,47,12,98,15,12,94,32,12,98,19,32,12,94,32,12,98,32,12,94,13,32,44,12,98,32,94,32,98,32,94,32,98,32,94,32,12,17,32,44,47,12,94,32,98,31,12,47,47,44,12,94,32,12,47,98,19,15,12,94,32,12,47,47,44,98,32,12,94,32,98,32,94,32,98,32,94,32,98,32,94,32,98,32,94,32,12,17,32,44,12,47,37,32,98,32,44,12,47,44,94,32,12,12,47,98,15,12,47,12,47,47,12,34,32,12,47,44,98,32,47,12,47,12,94,32,12,47,12,12,98,32,12,47,94,32,12,47,44,44,12,98,32,12,47,12,47,44,12,94,32,47,12,47,98,32,44,12,12,94,32,12,47,98,32,94,32,98,32,12,94,32,44,12,1020,32,37,32,98,15,12,94,32,47,98,32,
249,680,463,1598,1200,66776,70944,14151,13353,361,585,459,11681,7878,68568,274,69943,9882,12136,70344,2416,263,15817,2619,9080,2103,420,18123,459,67138,402,11923,11444,11444,4631,109272,648,459,3837,3836,421,16445,7735,13011,492,400,459,18829,9629,18049,78355,216254,459,12723,232351,402,7339,82265,2183,450,458,2166,75743,62233,400,1299,268954,6192,394,10746,90108,461,251443,16624,12723,14865,14286,449,142872,263,1349,5345,94223,400,13141,1978,298872,462,
