9,9,3,4,22,4,4,200,171,7,3,3,18,5,138,15,7,4,219,6,72,3,3,31,9,3,9,41,
10,10,4,5,26,9,5,201,172,11,4,4,25,6,139,17,8,5,222,7,73,4,4,32,10,4,10,46,
11,11,5,6,29,13,6,189,12,5,5,26,7,140,18,9,6,223,8,765,5,5,33,11,5,11,48,
12,12,6,7,30,14,7,190,14,6,6,27,8,141,19,10,7,224,9,830,6,6,34,12,6,12,50,
13,13,7,31,16,8,193,15,7,28,9,142,11,226,10,895,20,7,35,13,7,13,51,
14,14,8,33,54,215,16,8,29,10,143,12,227,11,960,21,8,39,14,8,14,53,
5284,54,57,216,1025,54,75,40,55,74,58,58,
