9,9,3,4,22,3,4,4,205,171,7,3,3,10,5,147,5,6,4,232,6,4355,3,3,39,9,3,9,63,
10,10,4,5,26,4,9,5,206,172,11,4,4,11,6,148,6,7,5,235,7,4420,4,4,40,10,4,10,65,
11,11,5,6,29,5,13,6,189,12,5,5,12,7,149,7,8,6,236,8,4485,5,5,41,11,5,11,67,
12,12,6,7,30,14,7,190,14,6,6,14,8,150,20,9,7,237,9,4550,6,6,42,12,6,12,72,
13,13,7,31,16,8,193,15,7,15,9,151,21,10,239,10,4615,20,7,43,13,7,13,73,
14,14,8,33,54,218,16,8,19,10,152,23,11,240,11,4680,21,8,44,14,8,14,74,
5292,62,65,222,4745,270,79,45,74,80,75,75,
