987,7,24,10,3,30,208,10,3,30,10,30,318,10,30,10,30,10,30,10,3,30,324,10,30,27,27,10,30,10,30,10,30,10,30,10,30,10,30,10,30,10,30,10,30,360,10,30,27,27,10,30,27,27,27,27,27,27,27,27,27,27,27,27,27,27,27,27,27,27,27,27,27,27,27,27,27,27,27,27,27,27,27,27,27,27,27,27,27,27,27,27,27,27,27,27,27,27,27,27,27,27,27,27,27,273,100,10,30,10,30,10,30,27,27,27,27,27,27,27,27,27,27,27,27,27,27,27,10,30,27,10,30,27,10,30,27,10,30,27,10,30,27,10,30,27,10,30,27,27,27,27,27,27,27,27,27,27,27,27,27,10,30,27,10,30,10,30,27,27,27,10,30,10,30,10,10,30,10,30,27,27,27,27,27,27,27,27,27,27,27,27,27,27,27,27,27,27,27,27,27,27,290,208,10,30,10,10,30,10,27,27,27,27,27,27,27,27,27,27,27,27,27,27,27,27,27,27,27,27,194,10,30,27,10,30,27,251,27,27,10,10,30,27,27,10,30,27,10,27,10,30,10,30,10,30,10,10,30,10,30,27,27,10,30,10,30,27,27,27,27,27,27,27,27,27,27,27,27,27,27,27,27,27,27,27,27,27,27,27,27,27,27,27,27,27,27,27,27,27,27,27,27,27,27,27,27,27,27,27,27,27,27,27,27,27,27,27,27,27,27,387,10,10,30,10,30,27,27,27,10,10,30,10,30,10,30,10,30,10,30,10,30,10,10,10,10,10,10,10,10,10,27,10,30,27,251,10,27,27,234,27,10,10,10,10,30,10,30,10,10,30,10,30,27,27,27,316,10,30,10,30,27,10,30,316,10,30,10,30,27,27,10,30,339,10,30,10,30,27,27,27,10,
988,8,25,11,4,31,209,11,4,31,11,31,319,11,31,11,31,11,31,11,4,31,325,11,31,28,28,11,31,11,31,11,31,11,31,11,31,11,31,11,31,11,31,11,31,363,11,31,28,28,11,31,28,28,28,28,28,28,28,28,28,28,28,28,28,28,28,28,28,28,28,28,28,28,28,28,28,28,28,28,28,28,28,28,28,28,28,28,28,28,28,28,28,28,28,28,28,28,28,28,28,28,28,28,28,274,101,11,31,11,31,11,31,28,28,28,28,28,28,28,28,28,28,28,28,28,28,28,11,31,28,11,31,28,11,31,28,11,31,28,11,31,28,11,31,28,11,31,28,28,28,28,28,28,28,28,28,28,28,28,28,11,31,28,11,31,11,31,28,28,28,11,31,11,31,11,11,31,11,31,28,28,28,28,28,28,28,28,28,28,28,28,28,28,28,28,28,28,28,28,28,28,291,209,11,31,11,11,31,11,28,28,28,28,28,28,28,28,28,28,28,28,28,28,28,28,28,28,28,28,195,11,31,28,11,31,28,252,28,28,11,11,31,28,28,11,31,28,11,28,11,31,11,31,11,31,11,11,31,11,31,28,28,11,31,11,31,28,28,28,28,28,28,28,28,28,28,28,28,28,28,28,28,28,28,28,28,28,28,28,28,28,28,28,28,28,28,28,28,28,28,28,28,28,28,28,28,28,28,28,28,28,28,28,28,28,28,28,28,28,28,388,11,11,31,11,31,28,28,28,11,11,31,11,31,11,31,11,31,11,31,11,31,11,11,11,11,11,11,11,11,11,28,11,31,28,252,11,28,28,235,28,11,11,11,11,31,11,31,11,11,31,11,31,28,28,28,318,11,31,11,31,28,11,31,317,11,31,11,31,28,28,11,31,340,11,31,11,31,28,28,28,11,
989,9,26,12,5,32,210,12,5,32,12,32,320,12,32,12,32,12,32,12,5,32,326,12,32,29,29,12,32,12,32,12,32,12,32,12,32,12,32,12,32,12,32,12,32,373,12,32,29,29,12,32,29,29,29,29,29,29,29,29,29,29,29,29,29,29,29,29,29,29,29,29,29,29,29,29,29,29,29,29,29,29,29,29,29,29,29,29,29,29,29,29,29,29,29,29,29,29,29,29,29,29,29,29,29,275,102,12,32,12,32,12,32,29,29,29,29,29,29,29,29,29,29,29,29,29,29,29,12,32,29,12,32,29,12,32,29,12,32,29,12,32,29,12,32,29,12,32,29,29,29,29,29,29,29,29,29,29,29,29,29,12,32,29,12,32,12,32,29,29,29,12,32,12,32,12,12,32,12,32,29,29,29,29,29,29,29,29,29,29,29,29,29,29,29,29,29,29,29,29,29,29,292,210,12,32,12,12,32,12,29,29,29,29,29,29,29,29,29,29,29,29,29,29,29,29,29,29,29,29,196,12,32,29,12,32,29,253,29,29,12,12,32,29,29,12,32,29,12,29,12,32,12,32,12,32,12,12,32,12,32,29,29,12,32,12,32,29,29,29,29,29,29,29,29,29,29,29,29,29,29,29,29,29,29,29,29,29,29,29,29,29,29,29,29,29,29,29,29,29,29,29,29,29,29,29,29,29,29,29,29,29,29,29,29,29,29,29,29,29,29,389,12,12,32,12,32,29,29,29,12,12,32,12,32,12,32,12,32,12,32,12,32,12,12,12,12,12,12,12,12,12,29,12,32,29,253,12,29,29,236,29,12,12,12,12,32,12,32,12,12,32,12,32,29,29,29,323,12,32,12,32,29,12,32,319,12,32,12,32,29,29,12,32,341,12,32,12,32,29,29,29,12,
990,10,33,13,6,33,211,13,6,33,13,33,321,13,33,13,33,13,33,13,6,33,327,13,33,30,30,13,33,13,33,13,33,13,33,13,33,13,33,13,33,13,33,13,33,374,13,33,30,30,13,33,30,30,30,30,30,30,30,30,30,30,30,30,30,30,30,30,30,30,30,30,30,30,30,30,30,30,30,30,30,30,30,30,30,30,30,30,30,30,30,30,30,30,30,30,30,30,30,30,30,30,30,30,30,276,103,13,33,13,33,13,33,30,30,30,30,30,30,30,30,30,30,30,30,30,30,30,13,33,30,13,33,30,13,33,30,13,33,30,13,33,30,13,33,30,13,33,30,30,30,30,30,30,30,30,30,30,30,30,30,13,33,30,13,33,13,33,30,30,30,13,33,13,33,13,13,33,13,33,30,30,30,30,30,30,30,30,30,30,30,30,30,30,30,30,30,30,30,30,30,30,293,211,13,33,13,13,33,13,30,30,30,30,30,30,30,30,30,30,30,30,30,30,30,30,30,30,30,30,197,13,33,30,13,33,30,254,30,30,13,13,33,30,30,13,33,30,13,30,13,33,13,33,13,33,13,13,33,13,33,30,30,13,33,13,33,30,30,30,30,30,30,30,30,30,30,30,30,30,30,30,30,30,30,30,30,30,30,30,30,30,30,30,30,30,30,30,30,30,30,30,30,30,30,30,30,30,30,30,30,30,30,30,30,30,30,30,30,30,30,390,13,13,33,13,33,30,30,30,13,13,33,13,33,13,33,13,33,13,33,13,33,13,13,13,13,13,13,13,13,13,30,13,33,30,254,13,30,30,237,30,13,13,13,13,33,13,33,13,13,33,13,33,30,30,30,324,13,33,13,33,30,13,33,320,13,33,13,33,30,30,13,33,342,13,33,13,33,30,30,30,13,
991,11,34,14,7,34,212,14,7,34,14,34,322,14,34,14,34,14,34,14,7,34,344,14,34,31,31,14,34,14,34,14,34,14,34,14,34,14,34,14,34,14,34,14,34,375,14,34,31,31,14,34,31,31,31,31,31,31,31,31,31,31,31,31,31,31,31,31,31,31,31,31,31,31,31,31,31,31,31,31,31,31,31,31,31,31,31,31,31,31,31,31,31,31,31,31,31,31,31,31,31,31,31,31,31,277,104,14,34,14,34,14,34,31,31,31,31,31,31,31,31,31,31,31,31,31,31,31,14,34,31,14,34,31,14,34,31,14,34,31,14,34,31,14,34,31,14,34,31,31,31,31,31,31,31,31,31,31,31,31,31,14,34,31,14,34,14,34,31,31,31,14,34,14,34,14,14,34,14,34,31,31,31,31,31,31,31,31,31,31,31,31,31,31,31,31,31,31,31,31,31,31,294,212,14,34,14,14,34,14,31,31,31,31,31,31,31,31,31,31,31,31,31,31,31,31,31,31,31,31,198,14,34,31,14,34,31,255,31,31,14,14,34,31,31,14,34,31,14,31,14,34,14,34,14,34,14,14,34,14,34,31,31,14,34,14,34,31,31,31,31,31,31,31,31,31,31,31,31,31,31,31,31,31,31,31,31,31,31,31,31,31,31,31,31,31,31,31,31,31,31,31,31,31,31,31,31,31,31,31,31,31,31,31,31,31,31,31,31,31,31,391,14,14,34,14,34,31,31,31,14,14,34,14,34,14,34,14,34,14,34,14,34,14,14,14,14,14,14,14,14,14,31,14,34,31,255,14,31,31,238,31,14,14,14,14,34,14,34,14,14,34,14,34,31,31,31,339,14,34,14,34,31,14,34,321,14,34,14,34,31,31,14,34,343,14,34,14,34,31,31,31,14,
992,12,35,15,8,35,213,15,8,35,15,35,323,15,35,15,35,15,35,15,8,35,345,15,35,32,32,15,35,15,35,15,35,15,35,15,35,15,35,15,35,15,35,15,35,376,15,35,32,32,15,35,32,32,32,32,32,32,32,32,32,32,32,32,32,32,32,32,32,32,32,32,32,32,32,32,32,32,32,32,32,32,32,32,32,32,32,32,32,32,32,32,32,32,32,32,32,32,32,32,32,32,32,32,32,278,105,15,35,15,35,15,35,32,32,32,32,32,32,32,32,32,32,32,32,32,32,32,15,35,32,15,35,32,15,35,32,15,35,32,15,35,32,15,35,32,15,35,32,32,32,32,32,32,32,32,32,32,32,32,32,15,35,32,15,35,15,35,32,32,32,15,35,15,35,15,15,35,15,35,32,32,32,32,32,32,32,32,32,32,32,32,32,32,32,32,32,32,32,32,32,32,295,213,15,35,15,15,35,15,32,32,32,32,32,32,32,32,32,32,32,32,32,32,32,32,32,32,32,32,199,15,35,32,15,35,32,256,32,32,15,15,35,32,32,15,35,32,15,32,15,35,15,35,15,35,15,15,35,15,35,32,32,15,35,15,35,32,32,32,32,32,32,32,32,32,32,32,32,32,32,32,32,32,32,32,32,32,32,32,32,32,32,32,32,32,32,32,32,32,32,32,32,32,32,32,32,32,32,32,32,32,32,32,32,32,32,32,32,32,32,392,15,15,35,15,35,32,32,32,15,15,35,15,35,15,35,15,35,15,35,15,35,15,15,15,15,15,15,15,15,15,32,15,35,32,256,15,32,32,239,32,15,15,15,15,35,15,35,15,15,35,15,35,32,32,32,340,15,35,15,35,32,15,35,322,15,35,15,35,32,32,15,35,344,15,35,15,35,32,32,32,15,
1211,650,400,230,214,140,561,325,416,334,380,478,4161,346,397,310,325,336,222,2662,366,486,149,371,511,343,310,377,323,6190,4229,2202,5166,5798,3837,4621,5797,1736,3053,5405,1873,4229,1357,5405,5013,5013,5013,210,181,357,209,219,430,210,148,209,209,209,377,140,419,158,213,389,357,634,237,377,217,377,504,408,301,438,148,389,377,219,212,178,430,148,377,377,400,218,279,106,933,209,302,334,213,357,377,209,634,504,408,217,697,158,181,181,209,209,505,334,219,225,553,212,222,321,401,316,384,182,150,542,378,150,713,149,367,517,209,315,210,216,305,212,148,184,218,184,198,316,364,238,185,357,170,296,147,284,349,181,160,404,218,510,378,510,334,210,321,159,232,225,209,148,148,377,229,389,208,357,504,301,229,498,212,745,210,709,592,181,435,357,296,214,263,428,321,853,378,657,812,408,408,585,560,436,202,357,178,357,210,357,237,219,497,148,308,408,400,170,200,346,210,265,454,211,153,760,226,184,451,181,597,237,249,181,302,222,833,326,353,309,327,269,517,159,170,321,271,170,187,181,209,321,695,186,409,560,377,585,427,170,377,377,181,330,377,181,389,389,389,219,400,573,202,225,316,310,189,186,965,700,148,430,219,302,364,148,308,128,573,148,560,181,181,209,389,357,222,357,217,427,560,219,237,211,396,128,181,360,148,393,880,455,309,334,230,400,400,334,321,401,151,561,258,307,395,397,151,358,583,428,850,1337,321,719,1141,391,327,530,186,284,530,390,406,334,184,240,180,327,335,217,265,273,371,219,159,327,397,261,401,357,189,364,341,408,409,1111,141,158,334,209,323,327,561,530,182,217,189,517,439,345,371,309,846,303,210,220,181,321,
