17,190,18,43,61,21,1197,18,64,61,16,61,
18,191,19,45,62,22,1198,19,65,62,17,62,
19,192,20,46,63,23,1199,20,66,63,18,63,
20,193,21,47,64,24,1200,21,67,64,19,64,
21,194,22,48,65,25,1201,22,68,65,20,65,
22,195,23,56,66,26,1202,23,69,66,21,66,
253,63,62,67,27,1257,49,70,67,22,67,
