32,220,106,106,106,106,284,13,8,60,60,60,
33,221,107,107,107,107,285,14,9,61,61,61,
34,222,108,108,108,108,286,15,10,62,62,62,
35,223,109,109,109,109,287,16,11,63,63,63,
36,224,110,110,110,110,288,17,12,64,64,64,
37,225,111,111,111,111,289,18,13,65,65,65,
192,614,179810,612,1865,568,724,969,
