455,11,3,233,158,39,17,5,25,15,7,8,11,23,26,22,26,5,5,24,17,46,37,23,23,23,
462,12,4,159,40,18,7,26,16,8,9,12,24,27,23,27,6,6,25,18,48,38,24,24,24,
463,13,5,160,41,19,8,27,17,9,10,13,25,28,24,7,7,26,19,49,39,25,25,25,
464,14,6,161,42,20,9,28,18,10,11,14,28,29,25,8,8,28,20,50,40,26,26,26,
465,15,7,162,43,21,10,31,19,11,12,15,29,31,26,9,9,29,21,51,41,27,27,27,
466,16,8,163,44,22,11,32,20,12,13,16,30,32,27,10,10,30,22,52,42,28,28,30,
508,219,45,23,12,33,21,13,15,64,31,33,28,49,31,23,53,43,29,29,31,
