753,3,7,3,3,59,58,46,51,58,57,59,57,57,58,57,58,57,57,59,49,37,57,57,57,57,58,57,57,59,57,59,57,57,58,57,57,59,57,59,57,57,57,57,59,57,57,57,59,57,57,57,57,57,57,57,57,57,57,57,57,57,57,57,57,45,57,39,43,55,57,57,51,57,45,57,43,47,57,41,57,57,57,47,57,55,35,56,39,57,51,55,57,57,56,57,57,49,57,45,57,57,57,51,48,55,38,57,40,54,56,57,57,57,43,57,57,57,39,51,57,35,43,47,57,55,59,57,57,43,52,58,51,45,49,46,57,58,9,41,34,47,55,40,54,43,42,51,43,37,50,42,57,57,57,57,57,57,39,35,57,51,59,56,39,39,57,56,40,57,57,57,43,39,59,57,49,35,51,43,45,41,57,35,41,39,57,39,57,57,57,56,57,57,57,55,57,57,57,57,57,57,57,37,58,55,57,59,59,57,53,57,57,57,57,57,45,51,57,57,43,57,55,35,57,57,57,57,43,39,41,59,53,55,58,57,39,57,49,41,58,59,59,39,42,58,59,57,51,59,41,51,55,39,58,47,57,51,59,57,59,57,57,45,59,57,37,57,41,47,57,57,57,57,57,41,57,57,43,57,57,57,55,57,57,45,57,39,56,57,57,49,45,57,49,47,57,35,47,57,39,52,51,57,57,51,57,39,33,39,57,57,50,43,39,57,45,57,37,39,57,57,54,57,59,39,59,57,51,57,58,55,37,43,59,39,59,55,59,57,59,57,43,57,59,41,59,37,59,37,59,59,59,58,45,57,40,51,59,34,57,54,37,50,37,57,39,58,53,57,57,43,57,57,49,35,57,57,56,47,43,59,57,57,47,57,54,41,57,47,57,57,56,57,57,48,59,57,59,57,43,41,57,59,
754,4,8,4,4,60,59,48,52,59,58,60,58,58,59,58,59,58,58,60,50,38,58,58,58,58,59,58,58,60,58,60,58,58,59,58,58,60,58,60,58,58,58,58,60,58,58,58,60,58,58,58,58,58,58,58,58,58,58,58,58,58,58,58,58,46,58,40,44,56,58,58,52,58,46,58,44,48,58,42,58,58,58,48,58,56,36,57,40,58,52,56,58,58,57,58,58,50,58,46,58,58,58,52,49,56,39,58,41,55,57,58,58,58,44,58,58,58,40,52,58,36,46,48,58,58,60,58,58,44,53,59,52,46,50,47,58,59,10,42,35,48,56,41,55,48,43,52,44,38,51,43,58,58,58,58,58,58,40,36,58,52,60,57,40,40,58,57,41,58,58,58,44,40,60,58,50,36,52,44,46,42,58,36,42,40,58,40,58,58,58,58,58,58,58,56,58,58,58,58,58,58,58,38,59,56,58,60,60,58,54,58,58,58,58,58,46,52,58,58,44,58,56,36,58,58,58,58,44,40,42,60,54,56,59,58,40,58,50,42,59,60,60,40,43,59,60,58,52,60,42,52,56,40,59,48,58,52,60,58,60,58,58,46,60,58,38,58,42,48,58,58,58,58,58,42,58,58,44,58,58,58,56,58,58,46,58,40,57,58,58,50,46,58,50,48,58,36,48,58,40,53,52,58,58,52,58,40,34,40,58,58,51,44,40,58,46,58,38,40,58,58,55,58,60,40,60,58,53,58,59,56,38,44,60,40,60,56,60,58,60,58,44,58,60,42,60,38,60,38,60,60,60,59,46,58,41,52,60,35,58,55,38,51,38,58,40,59,54,58,58,44,58,58,50,36,58,58,57,48,44,60,58,58,48,58,55,42,58,48,58,58,57,58,58,49,60,58,60,58,44,42,58,60,
755,5,9,5,5,61,60,49,53,60,59,61,60,59,60,59,60,59,59,61,51,39,59,59,59,59,60,59,59,61,59,61,59,59,60,59,59,61,59,61,59,59,59,59,61,59,59,59,61,59,59,59,59,59,59,59,59,59,59,59,59,59,59,59,59,47,59,41,47,57,59,59,53,59,47,59,45,49,59,43,59,59,59,49,59,57,41,58,41,59,53,57,59,59,58,59,59,51,59,49,59,59,59,53,50,57,40,59,42,56,59,59,59,59,45,59,59,59,41,53,59,41,47,49,59,59,61,59,59,47,54,60,53,47,51,48,59,60,11,43,36,49,57,42,57,49,44,53,45,39,52,44,59,59,59,59,59,59,41,37,59,57,61,58,41,41,59,58,42,59,59,59,45,41,61,59,51,37,53,45,47,43,59,37,45,41,59,41,59,59,59,59,59,59,59,57,59,59,59,59,59,59,59,39,60,57,59,61,61,59,55,59,59,59,59,59,47,53,59,59,45,59,59,41,59,59,59,59,45,41,43,61,55,57,60,59,41,59,51,43,60,61,61,41,44,60,61,59,53,61,43,54,57,41,60,51,59,53,61,59,61,59,59,47,61,59,39,59,43,49,59,59,59,59,59,43,59,59,47,59,59,59,57,59,59,47,59,41,58,59,59,52,49,59,51,49,59,41,49,59,41,54,53,59,59,53,59,41,35,41,59,59,53,47,41,59,47,59,39,41,59,59,56,59,61,41,61,59,54,59,60,57,39,45,61,41,61,57,61,59,61,59,51,59,61,43,61,39,61,39,61,61,61,60,47,59,42,53,61,36,59,56,39,53,39,59,41,60,55,59,59,45,59,59,51,41,59,59,58,49,45,61,59,59,49,59,56,43,59,49,59,59,58,59,59,50,61,59,61,59,47,43,59,61,
756,6,10,6,6,62,61,50,54,61,60,62,61,60,61,60,61,60,60,62,52,40,60,60,60,60,61,60,60,62,60,62,60,60,61,60,60,62,60,62,60,60,60,60,62,60,60,60,62,60,60,60,60,60,60,60,60,60,60,60,60,60,60,60,60,48,60,42,48,58,60,60,54,60,48,60,46,50,60,46,60,60,60,53,60,58,42,60,42,60,54,58,60,60,59,60,60,52,60,50,60,60,60,54,52,58,41,60,43,57,60,60,60,60,46,60,60,60,42,54,60,42,48,50,60,60,62,60,60,48,55,61,54,48,52,49,60,61,12,46,37,50,58,43,58,50,45,56,46,40,53,50,60,60,60,60,60,60,42,38,60,58,62,59,42,42,60,59,43,60,60,60,46,42,62,60,52,38,54,46,48,46,60,38,46,42,60,42,60,60,60,60,60,60,60,58,60,60,60,60,60,60,60,40,61,58,60,62,62,60,56,60,60,60,60,60,48,55,60,60,46,60,60,42,60,60,60,60,46,42,44,62,56,58,61,60,42,60,52,45,61,62,62,42,45,61,62,60,54,62,44,55,58,42,61,52,60,54,62,60,62,60,60,48,62,60,40,60,44,53,60,60,60,60,60,44,60,60,48,60,60,60,58,60,60,48,60,42,59,60,60,53,50,60,52,53,60,42,52,60,42,60,54,60,60,54,60,42,36,42,60,60,54,48,42,60,48,60,40,42,60,60,57,60,62,42,62,60,55,60,61,58,40,46,62,42,62,58,62,60,62,60,52,60,62,44,62,40,62,40,62,62,62,61,48,60,43,54,62,37,60,57,40,54,40,60,42,61,57,60,60,46,60,60,53,42,60,60,59,50,46,62,60,60,50,60,57,44,60,50,60,60,60,60,60,51,62,60,62,60,48,44,60,62,
757,7,11,7,7,63,62,51,55,62,61,63,62,61,62,61,62,61,61,63,53,41,61,61,61,61,62,61,61,63,61,63,61,61,62,61,61,63,61,63,61,61,61,61,63,61,61,61,63,61,61,61,61,61,61,61,61,61,61,61,61,61,61,61,61,49,61,43,49,59,61,61,55,61,49,61,47,53,61,47,61,61,61,54,61,59,43,61,43,61,55,59,61,61,60,61,61,53,61,51,61,61,61,55,53,59,42,61,44,58,61,61,61,61,47,61,61,61,43,55,61,43,49,51,61,61,63,61,61,49,56,62,55,49,53,50,61,62,13,47,38,51,59,44,59,51,46,57,47,41,54,51,61,61,61,61,61,61,45,39,61,59,63,60,43,43,61,60,44,61,61,61,47,43,63,61,53,39,55,47,49,47,61,39,47,43,61,43,61,61,61,61,61,61,61,59,61,61,61,61,61,61,61,41,62,59,61,63,63,61,57,61,61,61,61,61,49,56,61,61,47,61,61,43,61,61,61,61,47,43,45,63,57,59,62,61,43,61,53,46,62,63,63,43,46,62,63,61,55,63,45,57,59,43,62,55,61,57,63,61,63,61,61,49,63,61,41,61,45,54,61,61,61,61,61,45,61,61,49,61,61,61,59,61,61,49,61,43,61,61,61,56,51,61,53,54,61,43,53,61,43,61,55,61,61,55,61,43,37,43,61,61,55,49,43,61,49,61,41,43,61,61,58,61,63,43,63,61,56,61,62,59,41,47,63,43,63,59,63,61,63,61,53,61,63,47,63,43,63,41,63,63,63,62,49,61,44,56,63,38,61,58,41,55,41,61,43,62,58,61,61,47,61,61,54,43,61,61,60,51,47,63,61,61,51,61,59,45,61,51,61,61,61,61,61,52,63,61,63,61,49,47,61,63,
758,8,12,8,8,64,63,52,56,63,63,64,63,62,63,62,63,62,62,66,54,42,62,62,62,63,63,62,62,66,62,64,62,63,63,62,62,66,62,64,62,63,62,62,64,62,62,62,66,62,62,62,62,62,62,62,62,62,62,62,62,62,62,62,62,50,62,44,50,60,62,62,56,62,50,62,48,54,62,48,62,62,62,55,62,60,44,62,44,62,57,60,62,62,61,62,62,54,62,52,62,62,62,56,54,60,43,62,45,60,62,62,62,62,48,62,62,62,44,56,62,44,50,52,62,62,64,62,62,50,57,63,56,52,54,51,62,63,14,48,39,52,60,45,60,52,47,58,48,42,55,52,62,62,62,62,62,62,46,40,62,60,64,61,46,46,62,61,45,62,62,62,48,46,64,62,54,40,56,48,52,48,62,40,48,44,62,44,62,62,62,62,62,62,62,60,62,62,62,62,62,62,62,42,63,60,62,64,66,62,58,62,62,62,62,62,50,57,62,62,48,62,62,44,62,62,62,62,48,44,46,64,58,60,63,62,44,62,54,47,63,64,66,46,47,63,64,62,56,64,46,58,60,46,63,56,62,58,64,62,64,62,62,50,66,62,42,62,46,55,62,62,62,62,62,48,62,62,50,62,62,62,60,62,62,50,62,44,62,62,62,57,52,62,54,55,62,44,54,62,44,62,56,62,62,56,62,44,38,44,62,62,57,50,44,62,50,62,42,44,62,62,59,62,64,44,66,62,57,62,63,60,42,48,64,44,64,60,66,62,64,62,54,62,64,48,64,44,64,42,64,64,64,63,50,62,45,57,64,39,62,59,42,56,42,63,46,63,59,62,62,48,62,63,55,44,62,62,61,52,48,66,62,62,52,62,60,46,62,52,62,62,62,62,62,53,64,62,66,62,50,48,62,66,
777,59,65,63,43,65,64,53,57,64,64,65,64,63,64,63,64,63,64,67,55,43,64,63,64,64,64,63,64,67,63,65,63,64,64,63,64,67,63,65,64,64,64,63,65,64,64,64,67,64,64,64,64,64,64,64,64,64,64,64,64,64,64,63,64,51,64,47,51,62,63,63,57,63,51,63,49,55,63,49,63,63,63,56,63,61,45,63,47,63,58,61,63,63,62,63,63,55,64,53,63,63,63,57,55,61,44,63,46,61,63,63,63,64,49,63,63,63,47,57,63,45,51,53,63,63,65,63,63,51,58,64,57,53,55,52,63,64,15,49,40,53,61,46,61,53,48,59,49,46,56,53,63,63,63,63,64,63,47,47,63,61,65,62,47,47,63,62,46,63,64,63,49,47,65,63,55,41,57,49,53,49,64,41,49,47,63,47,63,63,63,63,63,63,63,61,63,63,63,63,63,63,63,43,64,61,63,65,67,63,59,63,63,63,63,63,51,58,63,63,49,63,63,45,63,63,64,63,49,47,47,65,59,61,64,63,47,63,55,48,64,65,67,47,48,64,65,63,57,65,47,59,61,47,64,57,63,59,65,63,65,64,63,51,67,63,43,63,47,56,63,64,63,64,63,49,64,63,51,64,63,63,61,63,63,51,63,45,63,63,63,58,53,63,55,56,63,45,56,63,45,63,57,63,63,57,63,47,39,47,63,63,58,51,45,63,51,63,43,45,63,63,60,63,65,45,67,63,58,63,64,61,43,49,65,47,65,61,67,63,65,63,55,63,65,49,65,45,65,43,65,65,65,64,51,63,46,58,65,40,63,60,43,57,43,64,47,64,60,63,64,49,63,64,56,45,64,63,62,53,49,67,63,63,53,63,61,47,64,53,63,63,63,63,64,54,65,63,67,64,51,49,63,67,
