3,4,5,117,484,5,8,85,3,314,18,8,9,6,3,3,59,49,71,57,58,58,53,66,51,60,57,53,51,69,57,53,42,75,57,53,47,71,57,53,49,72,57,53,50,71,47,71,49,49,53,41,75,58,53,58,49,47,70,53,50,68,53,51,78,53,58,47,84,48,67,58,49,48,68,53,42,78,48,65,47,78,47,68,53,57,53,47,78,42,74,53,57,58,53,51,78,54,58,53,49,62,58,53,57,58,58,49,51,78,49,57,53,49,38,49,57,53,48,78,53,57,53,48,78,53,57,53,51,78,53,57,53,48,78,49,48,78,53,48,65,49,48,78,53,48,64,49,48,78,58,49,48,78,48,78,42,73,48,78,47,71,42,80,49,46,43,58,57,53,47,78,51,79,53,58,57,58,53,48,78,49,57,49,78,53,42,78,53,58,57,58,49,63,53,49,78,42,60,47,78,48,78,47,78,48,73,48,78,50,71,50,80,53,48,43,58,49,57,47,78,49,78,58,49,58,58,48,78,53,49,57,49,78,53,57,53,58,57,49,51,27,53,57,58,52,63,58,49,57,49,48,78,53,58,49,49,51,64,49,58,54,78,53,58,58,58,49,42,78,49,57,49,57,58,49,51,78,57,53,57,51,73,58,49,49,47,78,49,58,51,68,51,69,50,54,53,47,70,58,49,48,78,47,72,42,80,53,42,67,58,47,70,
4,5,6,118,485,6,9,86,4,315,19,9,10,7,4,4,62,50,72,59,59,59,54,67,52,61,58,54,52,70,58,54,43,76,58,54,48,72,59,54,51,73,59,54,51,72,48,72,50,51,54,42,76,59,54,59,50,48,71,54,51,69,54,52,79,54,59,48,85,49,68,59,50,49,69,54,43,79,49,66,48,79,48,69,54,58,54,48,79,43,75,54,58,59,54,52,79,55,59,54,50,64,59,54,58,59,59,50,52,79,50,58,54,50,39,50,58,54,49,79,54,58,54,49,79,54,58,54,52,79,54,58,54,49,79,50,49,79,54,49,66,50,49,79,54,49,65,50,49,79,59,50,49,79,49,79,43,74,49,79,48,72,48,81,50,47,44,59,58,54,48,79,52,80,54,59,58,59,54,49,79,50,58,50,79,54,49,79,54,59,58,59,50,64,54,50,79,43,61,48,79,49,79,48,79,49,74,49,79,51,72,51,81,54,49,44,59,50,58,48,79,50,79,59,50,59,59,49,79,54,50,58,50,79,54,59,54,59,59,50,52,28,54,58,59,53,64,59,50,58,50,49,79,54,59,50,50,52,65,50,59,55,79,54,59,59,59,50,43,79,50,58,50,58,59,50,52,79,59,54,59,52,74,59,50,50,48,79,50,59,52,69,52,70,51,55,54,48,71,59,50,49,79,48,73,43,81,54,43,68,59,48,71,
5,6,7,119,486,7,10,87,5,316,20,10,11,8,5,5,63,51,73,60,60,60,55,68,53,62,59,55,53,71,59,55,44,77,59,55,49,73,60,55,52,74,60,55,52,73,49,73,51,52,55,43,77,60,55,60,51,49,72,55,52,70,55,53,80,55,60,49,86,50,69,60,51,50,70,55,44,80,50,67,49,80,49,70,55,59,55,49,80,44,76,55,59,60,55,53,80,56,60,55,51,65,60,55,59,60,60,51,53,80,51,59,55,51,40,51,59,55,50,80,55,59,55,50,80,55,59,55,53,80,55,59,55,50,80,51,50,80,55,50,67,51,50,80,55,50,66,51,50,80,60,51,50,80,50,80,44,75,50,80,49,73,49,82,51,48,45,60,59,55,49,80,53,81,55,60,59,60,55,50,80,51,59,51,80,55,50,80,55,60,59,60,51,65,55,51,80,44,62,49,80,50,80,49,80,50,75,50,80,52,73,52,82,55,50,45,60,51,59,49,80,51,80,60,51,60,60,50,80,55,51,59,51,80,55,60,55,60,60,51,53,29,55,59,60,54,65,60,51,59,51,50,80,55,60,51,51,53,66,51,60,56,80,55,60,60,60,51,44,80,51,59,51,59,60,51,53,80,60,55,60,53,75,60,51,51,49,80,51,60,53,70,53,71,52,56,55,49,72,60,51,50,80,49,74,44,82,55,44,69,60,49,72,
6,7,8,120,487,8,11,88,6,317,21,11,12,9,6,6,64,52,74,61,61,61,56,69,54,63,61,56,54,72,61,56,45,78,61,56,50,74,61,56,53,75,61,56,53,74,50,74,52,53,56,44,78,61,56,61,52,50,73,56,53,71,56,54,81,56,61,50,87,51,70,61,52,51,71,56,45,81,51,68,50,81,50,71,56,61,57,50,81,45,79,56,61,61,56,54,81,62,61,56,52,66,61,56,61,61,61,52,54,81,52,61,56,52,41,52,61,56,51,81,56,61,57,51,81,56,61,57,54,81,56,61,57,51,81,52,51,81,56,51,68,52,51,81,56,51,67,52,51,81,61,52,51,81,51,81,45,76,51,81,50,74,50,83,52,49,46,61,61,57,50,81,54,82,56,61,61,61,56,51,81,52,61,52,81,56,51,81,56,61,61,61,52,66,57,52,81,45,63,50,81,51,81,50,81,51,76,51,81,53,74,53,83,56,51,46,61,52,61,50,81,52,81,61,52,61,61,51,81,56,52,61,52,81,57,61,56,61,61,52,54,30,56,61,61,55,66,61,52,61,52,51,81,57,61,52,52,54,67,52,61,57,81,56,61,61,61,52,45,81,52,61,52,61,61,52,54,81,61,57,61,54,76,61,52,52,50,81,52,61,54,71,54,72,53,57,57,50,73,61,52,51,81,50,75,45,83,56,45,70,61,50,73,
7,8,9,9,12,89,7,318,22,12,24,10,7,7,65,53,75,62,63,62,57,71,58,64,62,57,56,73,62,57,52,79,62,57,51,75,62,57,54,76,62,57,54,75,51,75,53,54,57,51,79,62,57,62,55,51,74,57,54,72,57,55,82,57,62,51,88,52,71,63,55,52,72,57,51,82,52,69,51,82,51,72,57,62,58,51,82,46,80,57,62,63,57,55,82,63,62,57,53,67,62,57,62,63,63,55,57,82,55,62,57,53,42,53,62,57,52,82,57,62,58,52,82,57,62,58,57,82,57,62,58,52,82,53,52,82,57,52,69,53,52,82,57,52,68,55,52,82,63,53,52,82,52,82,46,77,52,82,51,75,51,84,55,50,47,63,62,58,51,82,55,83,57,62,62,63,57,52,82,55,62,53,82,57,52,82,57,62,62,63,53,67,58,53,82,53,64,51,82,52,82,51,82,52,77,52,82,54,75,54,84,57,52,47,63,55,62,51,82,53,82,63,55,62,62,52,82,57,55,62,53,82,58,62,57,62,62,53,57,32,57,62,62,59,67,63,55,62,53,52,82,58,62,55,55,57,68,55,62,58,82,57,63,62,63,55,53,82,53,62,55,62,63,55,57,82,62,58,62,57,77,63,55,55,51,82,53,62,57,72,55,73,54,58,58,51,74,63,53,53,82,51,76,46,84,57,52,71,62,51,74,
8,9,10,13,90,8,319,23,13,25,11,14,8,66,54,76,63,64,63,59,72,59,65,63,59,57,74,63,59,53,80,63,59,52,76,63,59,55,77,63,59,55,76,52,76,54,55,58,52,80,63,59,63,56,52,75,59,58,73,59,58,83,59,63,52,89,53,72,64,56,53,73,59,52,83,53,70,52,83,52,73,59,63,59,52,83,53,81,59,63,64,59,58,83,64,63,59,54,68,63,59,63,64,64,56,58,83,56,63,59,54,43,56,63,59,53,83,59,63,59,53,83,59,63,59,58,83,59,63,59,53,83,56,53,83,59,53,70,56,53,83,59,53,69,56,53,83,64,56,53,83,53,83,52,78,53,83,52,76,52,85,56,53,48,64,63,59,52,83,59,84,59,63,63,64,59,53,83,56,63,54,83,59,53,83,59,63,63,64,54,68,59,54,83,54,65,52,83,53,83,52,83,53,78,53,83,55,76,55,85,58,53,48,64,56,63,52,83,54,83,64,56,63,63,53,83,59,56,63,54,83,59,63,59,63,63,56,58,33,59,63,63,60,68,64,56,63,56,53,83,59,63,56,56,58,69,56,63,59,83,59,64,63,64,56,54,83,56,63,56,63,64,56,58,83,63,59,63,58,78,64,56,56,52,83,56,63,58,73,58,74,58,59,59,52,75,64,56,54,83,52,77,52,85,58,53,72,63,52,75,
64,91,91,76,68,64,57,67,55,77,64,65,64,60,73,60,66,64,60,58,75,64,60,54,81,64,60,53,77,64,60,60,78,64,60,59,77,53,77,55,60,59,53,81,64,60,64,57,53,76,60,59,74,60,59,84,60,64,53,90,54,73,65,57,54,74,60,53,84,54,71,53,84,53,74,60,64,65,53,84,54,82,60,64,65,60,59,84,71,64,60,55,69,64,60,64,65,65,57,59,84,57,64,60,55,44,57,64,60,54,84,60,64,65,54,84,60,64,65,59,84,60,64,65,54,84,57,54,84,60,54,71,57,54,84,60,54,70,57,54,84,65,57,54,84,54,84,53,79,54,84,53,77,53,86,57,54,49,65,64,65,53,84,60,85,60,64,64,65,60,54,84,57,64,55,84,60,54,84,60,64,64,65,55,69,65,55,84,55,66,53,84,54,84,53,84,54,79,54,84,59,77,59,86,59,54,49,65,57,64,53,84,55,84,65,57,64,64,54,84,60,57,64,55,84,65,64,60,64,64,57,59,34,60,64,64,61,69,65,57,64,57,54,84,65,64,57,57,59,70,57,64,60,84,60,65,64,65,57,55,84,57,64,57,64,65,57,59,84,64,65,64,59,79,65,57,57,53,84,57,64,59,74,59,75,59,60,65,53,76,65,57,55,84,53,78,53,86,59,54,73,64,53,76,
